Designer=by Thomas Tang (DZ)
Last Update=Last Updated: August 25, 2025
Translator Credit=
Language=Language
Loading=Loading
Create Puzzle=Create Puzzle
Play=Play
Practice Minigame=Practice Minigame
Delete=Delete Scores
Tiles=Tiles
Minigames=Minigames
Minigame Count=One Minigame per $Num$ Tiles
Revealing Tiles=Revealing tiles for $Num$ sec
Find This Tile=Find This Tile
Time for Minigame=Time to play a minigame!
Minigame Explanation=The better you do in this minigame, the more time you'll get to glance at the remaining tiles.
Begin=Begin
Done=Done
Fail Minigame=Fail Minigame
Victory=You Won!
Lost=You Lost.
Next Minigame=Next Minigame in $Num$ Tiles
No More Minigames=No More Minigames
N/A=N/A
Mistakes Left=Mistakes Left: $Num$
Correct Tile=Correct!
Wrong Tile=Wrong! Try again.
Amazing Text=You did amazing!
Amazing Letter=A
Good Text=You did good.
Good Letter=B
Barely Text=You barely won.
Barely Letter=C
Failed Text=You failed.
Failed Letter=D
Second Glance=Based on your performance, you get another look at the tiles.
Failed Glance=Since you failed the minigame, you don't get another look at the tiles.
Score=Score
No Score=No High Scores Found
High Score=High Score
Alphabet=Alphabet
Alphabet Tutorial=Type the 26 letters of the alphabet as quick as you can, starting at a random letter.
Type This=Type This Letter
Coin Collect=Coin Collect
Coin Collect Tutorial=Press space to send your character across the screen. Collect the coins and avoid the skulls.
Maze=Maze
Maze Tutorial=Use arrow keys / WASD to move around the maze and collect all the coins as quick as you can. The skulls reset you to the center.
Orbs=Orbs
Orbs Tutorial=Touch the orbs in the order they're generated. In between each one, you must also touch the one at the bottom.
Rocket Defense=Rocket Defense
Rocket Defense Tutorial=Rockets are vulnerable while charging up. Protect them from the bullets by clicking on them.
Conveyor Belts=Conveyor Belts
Conveyor Belts Tutorial=Change each conveyor belt to prevent the bombs from reaching the end. Each belt speeds up the more you change it.
